111111111
100C00001
1P000V0E1
100C00011
111111111
