111111111111111111111111111111111111111111111111111111111111
111111P01111111111111111111111111111111111111111111111111111
1111110C1111111111111111111111111111111111111111111111111111
1000C00000C0000C00111111111111111111111111111111111111111111
100000000000000000111111111111111111111111111111111111111111
1C0000C00000C00000111111111111111111111111111111111111111111
1000C1111110000000111111111111111111111111111111111111111111
111111111111100C11111111111111111111111111111111111111111111
1111111111111E1111111111111111111111111111111111111111111111
111111111111111111111111111111111111111111111111111111111111
