11111111
111111P1
111111C1
1000C001
10000001
1C0E00C1
1000C111
11111111
11111111
11111111
