1111111111111111111
1111110011111111111
1111110C11111111111
1000C00000C0000C001
100000D0000P0000001
1C0000C00000C000001
1000C11111100000001
1111111111111C0C111
1111111111111E11111
1111111111111111111
