11111111
111111P1
111111C1
1000C001
10000001
100E00C1
1000C001
10000001
1C111111
11111111
